111111111111111111111111111111
111111111100000000000111111111
111111111120000000000011111111
111110001000000000000001111111
100000001000000000000000011111
111100000000000000000000000000
111110000000000000000000000011
111111000000000000000000000111
111111111111100000000000011111
111111111111111100000000001111
111111555555511110000000011111
111115555555511110000001111111
111115555551111100000001111111
111111111111111100001111111111
111111110000000001111111111111
000000000000000001111111111111
100000000000000000000000111111
110000000011111111111111111111
111111111111111111111111111111
111111111111111111111111111111